YEAR,Ecological Reserve,Not Protected,Sanctuary Preservation Area,Special Use,total
1999,10,104,40,7,161
2000,18,152,49,9,228
2001,17,207,70,10,304
2002,16,275,56,8,355
2003,11,157,63,5,236
2004,4,89,31,2,126
2005,15,187,46,8,256
2006,18,230,69,10,327
2007,14,242,54,7,317
2008,16,289,62,9,376
2009,19,406,77,14,516
2010,16,279,71,13,379
2011,12,312,67,11,402
2012,16,302,82,16,416
2014,13,313,89,17,432
2016,12,299,82,11,404
total ,227,3843,1008,157,5235
